. t t t t t t t t t t t t
. . . . . . . . . . . . t
t t t t t t . t t t t . t
t . . . . . . . . . . . t
t t g t t t t t t t t t t
t . . . . . . . . . . . t
t t t t t t t t t t t t .

